keys,en,en,en,en,en,en,en,en,en,en,en,en,en,en
5,5,5,5,5,5,5,5,5,5,5,5,5,5,5
5,0,0,2,5,5,0,0,0,0,0,0,0,0,5
5,0,0,0,5,5,0,2,0,3,0,1,0,0,5
5,0,0,0,0,0,0,0,0,3,3,0,0,0,5
5,0,0,0,0,0,0,0,3,3,0,0,0,2,5
5,0,0,0,0,0,0,0,0,3,0,2,0,0,5
5,0,0,0,0,0,0,0,0,0,0,0,0,0,5
5,0,0,0,0,0,2,5,5,0,0,0,0,0,5
5,5,5,5,5,5,5,5,5,5,5,5,5,5,5
