x,x,x,x,x,x,x,x,x,x,x,x,x,x,x
x,o,o,o,o,2,o,x,o,o,o,o,o,o,x
x,o,o,o,o,o,o,x,o,3,3,o,2,o,x
x,o,o,2,x,o,o,o,o,1,3,o,o,o,x
x,o,o,o,o,o,o,o,2,3,3,3,o,o,x
x,o,o,o,o,o,o,x,x,o,3,o,o,o,x
x,o,o,o,o,o,o,0,o,o,o,2,2,o,x
x,o,o,o,o,o,o,o,o,o,o,o,o,o,x
x,x,x,x,x,x,x,x,x,x,x,x,x,x,x
