x,x,x,x,x,x,x,x,x,x,x,x,x,x,x
x,o,o,o,o,o,o,o,o,o,o,o,o,o,x
x,o,o,o,o,2,o,o,o,o,o,o,o,o,x
x,o,1,o,o,o,3,o,o,o,o,o,o,o,x
x,o,o,o,o,o,3,3,o,o,o,2,o,o,x
x,o,o,2,o,3,3,o,o,o,o,o,o,o,x
x,o,o,o,o,o,o,o,o,2,o,o,o,o,x
x,o,o,o,o,o,o,o,o,o,o,o,o,o,x
x,x,x,x,x,x,x,x,x,x,x,x,x,x,x
