x,x,x,x,x,x,x,x,x,x,x,x,x,x,x
x,o,o,o,o,2,o,o,o,o,o,o,o,o,x
x,o,o,o,o,o,o,o,3,o,o,o,o,o,x
x,o,o,o,o,o,o,2,3,3,o,o,o,o,x
x,o,o,o,o,o,o,o,o,3,3,2,o,o,x
x,o,o,1,o,o,2,o,o,o,3,o,o,o,x
x,o,o,o,o,o,o,o,o,o,o,o,o,o,x
x,o,o,o,o,o,o,o,o,o,o,o,2,o,x
x,x,x,x,x,x,x,x,x,x,x,x,x,x,x
